A	AH
A(2)	EY
BACKWARD	B AE K W ER D
FORWARD	F AO R W ER D
FULL	F UH L
HALF	HH AE F
HELLO	HH AH L OW
HELLO(2)	HH EH L OW
KINOVA	K IH N OW V AH
LEFT	L EH F T
LONGFEI	L AA N G F IY
LONGFEI(2)	L AA N G F IY
MOVE	M UW V
MOVO	M OW V OW
RIGHT	R AY T
ROBOTICS	R OW B AA T IH K S
SING	S IH NG
SONG	S AO NG
SPEED	S P IY D
STOP	S T AA P
STOP(2)	S T AH P
TURN	T ER N
ZHAO	ZH AW
ZHAO(2)	JH AW